		名詞	
あ	｜空《あ》	動詞カ行五段	
あっけ	｜呆気《あっけ》	名詞	
あいきょう	｜愛嬌《あいきょう》	名詞	
あいまみえ	｜相見《あいまみ》え	動詞一段	
あえ	｜喘《あえ》	動詞ガ行五段	
あえて	｜敢《あ》えて	副詞	
あお	｜扇《あお》	動詞ガ行五段	
あお	｜煽《あお》	動詞ラ行五段	
あお	｜呷《あお》	動詞ラ行五段	
あかね	｜茜《あかね》	名詞	
あきれ	｜呆《あき》れ	動詞一段	
あさって	｜明後日《あさって》	名詞	
あさもや	｜朝靄《あさもや》	名詞	
あざけ	｜嘲《あざけ》	動詞ラ行五段	
あし	｜葦《アシ》	名詞	
あした	｜明日《あした》	名詞	
あしら	｜遇《あしら》	動詞ワ行五段	
あしら	｜配《あしら》	動詞ワ行五段	
あせ	｜褪《あ》せ	動詞一段	
あちこち	｜彼方此方《あちこち》	名詞	
あつらえ	｜誂《あつら》え	動詞一段	
あてが	｜宛行《あてが》	動詞ワ行五段	
あとじさ	｜後退《あとじさ》	動詞ラ行五段	
あとずさ	｜後退《あとずさ》	動詞ラ行五段	
あなた	｜貴方《あなた》	名詞	
あなた	｜貴女《あなた》	名詞	
あびきょうかん	｜阿鼻叫喚《あびきょうかん》	名詞	
あふれ	｜溢《あふ》れ	動詞一段	
あぽかりぷす	｜黙示録《アポカリプス》	名詞	
あまた	｜数多《あまた》	名詞	
あまるがむ	｜水銀合金《アマルガム》	名詞	
あめあられ	｜雨霰《あめあられ》	名詞	
あらが	｜抗《あらが》	動詞ワ行五段	
あらた	｜検《あらた》	動詞マ行五段	
あらばすたー	｜雪花石膏《アラバスター》	名詞	
あられ	｜霰《あられ》	名詞	
あらわ	｜顕《あらわ》	名詞	
あるじ	｜主《あるじ》	名詞	
あんしょく	｜暗色《あんしょく》	名詞	
あんじょう	｜鞍上《あんじょう》	名詞	
あんど	｜安堵《あんど》	名詞	
い	｜行《い》	動詞カ行五段	
い・ぶらぜる	｜至福の島《イ・ブラゼル》	名詞	
いっかつ	｜一喝《いっかつ》	名詞サ変	
いっとき	｜一時《いっとき》	名詞	
いかん	｜如何《いかん》	名詞	
いきさつ	｜経緯《いきさつ》	名詞	
いく	｜偉?《いく》	名詞形動	
いくじ	｜意気地《いくじ》	名詞	
いくつ	｜幾《いく》つ	副詞	
いけにえ	｜生贄《いけにえ》	名詞	
いさかい	｜諍《いさか》い	名詞	
いざな	｜誘《いざな》	動詞ワ行五段	
いしおの	｜石斧《せきふ》	名詞	
いしゆみ	｜弩《いしゆみ》	名詞	
いたく	｜甚《いた》く	副詞	
いたずら	｜悪戯《いたずら》	名詞サ変	
いただ	｜戴《いただ》	動詞カ行五段	
いだ	｜抱《いだ》	動詞カ行五段	
いちじく	｜無花果《イチジク》	名詞	
いちせつな	｜一刹那《いちせつな》	名詞	
いちば	｜市場《いちば》	名詞	
いちべつ	｜一瞥《いちべつ》	名詞サ変	
いちる	｜一縷《いちる》	名詞	
いで	｜出《い》で	動詞一段	
いとま	｜暇《いとま》	名詞	
いな	｜否《いな》	名詞	
いにしえ	｜古《いにしえ》	名詞	
いばら	｜茨《いばら》	名詞	
いぶ	｜燻《いぶ》	動詞サ行五段	
いぶかし	｜訝《いぶか》し	動詞マ行五段	
いぶかしい	｜訝《いぶか》しい	名詞	
いやらし	｜厭《いや》らし	形容詞	
いらいら	｜苛々《いらいら》	名詞サ変	
いらだ	｜苛立《いらだ》	動詞タ行五段	
いりあいち	｜入会地《いりあいち》	名詞	
いれ	｜淹《い》れ	動詞一段	
いんぎん	｜慇懃《いんぎん》	名詞形動	
いんび	｜淫靡《いんび》	名詞形動	
うっそう	｜鬱蒼《うっそう》	副詞	
うかが	｜窺《うかが》	動詞ワ行五段	
うかつ	｜迂闊《うかつ》	名詞	
うが	｜穿《うが》	動詞タ行五段	
うごめ	｜蠢《うごめ》	動詞カ行五段	
うさぎ	｜兎《ウサギ》	名詞	
うさんくさ	｜胡散臭《うさんくさ》	形容詞	
うずくま	｜蹲《うずくま》	動詞ラ行五段	
うそ	｜嘘《うそ》	名詞	
うそぶ	｜嘯《うそぶ》	動詞カ行五段	
うたげ	｜宴《うたげ》	名詞	
うつむ	｜俯《うつむ》	動詞カ行五段	
うつろ	｜虚《うつ》ろ	名詞形動	
うな	｜唸《うな》	動詞ラ行五段	
うなず	｜頷《うなず》	動詞カ行五段	
うぬぼれ	｜自惚《うぬぼ》れ	動詞一段	
うぶ	｜初《うぶ》	名詞	
うま	｜旨《うま》	形容詞	
うま	｜上手《うま》	形容詞	
うま	｜美味《うま》	形容詞	
うまみ	｜旨味《うまみ》	名詞	
うめ	｜呻《うめ》	動詞カ行五段	
うらら	｜麗《うらら》	名詞形動	
うるさ	｜煩《うるさ》	形容詞	
うろ	｜洞《うろ》	名詞	
うろこ	｜鱗《うろこ》	名詞	
うわさ	｜噂《うわさ》	名詞	
うわて	｜上手《うわて》	名詞形動	
うんでぃーね	｜水の精霊《ウンディーネ》	名詞	
うんぬん	｜云々《うんぬん》	名詞	
えう゛ぁとん	｜海神の国《エヴァトン》	名詞	
えが	｜描《えが》	動詞カ行五段	
えきてい	｜駅逓《えきてい》	名詞	
えくせどら	｜壁龕《エクセドラ》	名詞	
えさ	｜餌《えさ》	名詞	
えにし	｜縁《えにし》	名詞	
えりじうむ	｜楽土《エリジウム》	名詞	
えん	｜縁《えん》	名詞	
えんすい	｜円錐《えんすい》	名詞	
えんせん	｜厭戦《えんせん》	名詞	
えんてい	｜堰堤《えんてい》	名詞	
えんどう	｜豌豆《エンドウ》	名詞	
お	｜追《お》	動詞ワ行五段	
お	｜捺《お》	動詞サ行五段	
おっくう	｜億劫《おっくう》	名詞形動	
おい	｜笈《おい》	名詞	
おいし	｜美味《おい》し	形容詞	
おうよう	｜鷹揚《おうよう》	名詞形動	
おえつ	｜嗚咽《おえつ》	名詞	
おおごと	｜大事《おおごと》	名詞	
おおぜい	｜大勢《おおぜい》	名詞	
おおむね	｜概《おおむ》ね	副詞	
おか	｜可笑《おか》	動詞サ行五段	
おくりな	｜諡《おくりな》	名詞	
おけ	｜桶《おけ》	名詞	
おこ	｜熾《おこ》	動詞サ行五段	
おこな	｜行《おこな》	動詞ワ行五段	
おご	｜奢《おご》	動詞ラ行五段	
おごそか	｜厳《おごそ》か	名詞形動	
おさ	｜長《おさ》	名詞	
おす	｜雄《おす》	名詞	
おぞけ	｜怖気《おぞけ》	名詞	
おぞまし	｜悍《おぞ》まし	形容詞	
おととい	｜一昨日《おととい》	名詞	
おとなげ	｜大人気《おとなげ》	副詞	
おとり	｜囮《おとり》	名詞	
おどけ	｜戯《おど》け	動詞一段	
おなご	｜女子《おなご》	名詞	
おのおの	｜各々《おのおの》	副詞	
おび	｜誘《おび》	動詞カ行五段	
おぼ	｜思《おぼ》	動詞サ行五段	
おぼろ	｜朧《おぼろ》	名詞形動	
おぼろづき	｜朧月《おぼろづき》	名詞	
おまもり	お｜守《まも》り	名詞	
おも	｜主《おも》	名詞	
おもむ	｜赴《おもむ》	動詞カ行五段	
おもむき	｜趣《おもむき》	名詞	
おもむろ	｜徐《おもむろ》	副詞	
おもり	お｜守《も》り	名詞	
おもんぱか	｜慮《おもんぱか》	動詞ラ行五段	
おわ	｜御座《おわ》	動詞サ行五段	
おんこ	｜御子《おんこ》	名詞	
おんしゅう	｜怨讐《おんしゅう》	名詞	
か	｜噛《か》	動詞マ行五段	
か	｜掻《か》	動詞カ行五段	
か	｜彼《か》	名詞	
か	｜描《か》	動詞カ行五段	
かい	｜甲斐《かい》	名詞	
かいこう	｜邂逅《かいこう》	名詞サ変	
かいざん	｜改竄《かいざん》	名詞サ変	
かいしょう	｜甲斐性《かいしょう》	名詞	
かいり	｜乖離《かいり》	名詞サ変	
かえって	｜却《かえ》って	副詞	
かか	｜拘《かか》	動詞ラ行五段	
かかし	｜案山子《かかし》	名詞	
かかずら	｜係《かか》ずら	動詞ワ行五段	
かかわ	｜拘《かか》わ	動詞ラ行五段	
かぎ	｜鉤《かぎ》	名詞	
かぎやり	｜鉤槍《かぎやり》	名詞	
かく	｜斯《か》く	副詞	
かくかくしかじか	｜斯く斯く然々《かくかくしかじか》	名詞	
かくま	｜匿《かくま》	動詞ワ行五段	
かけら	｜欠片《かけら》	名詞	
かざ	｜翳《かざ》	動詞サ行五段	
かし	｜樫《かし》	名詞	
かし	｜傾《かし》	動詞ガ行五段	
かしこ	｜畏《かしこ》	動詞ラ行五段	
かしこま	｜畏《かしこ》ま	動詞ラ行五段	
かしず	｜傅《かしず》	動詞カ行五段	
かじぼう	｜梶棒《かじぼう》	名詞	
かす	｜霞《かす》	動詞マ行五段	
かす	｜掠《かす》	動詞ラ行五段	
かす	｜滓《かす》	名詞	
かす	｜擦《かす》	動詞ラ行五段	
かすか	｜微《かす》か	名詞形動	
かすめ	｜掠《かす》め	動詞一段	
かずおお	｜数多《かずおお》	形容詞	
かせ	｜枷《かせ》	名詞	
かた	｜方《かた》	名詞	
かたい	｜下腿《かたい》	名詞	
かたき	｜敵《かたき》	名詞	
かたこんべ	｜地下墓所《カタコンベ》	名詞	
かたど	｜象《かたど》	動詞ラ行五段	
かたわら	｜傍《かたわ》ら	名詞	
かち	｜徒歩《かち》	名詞	
かつて	｜曽《かつ》て	副詞	
かど	｜角《かど》	名詞	
かどぐち	｜門口《かどぐち》	名詞	
かな	｜叶《かな》	動詞ワ行五段	
かな	｜敵《かな》	動詞ワ行五段	
かな	｜適《かな》	動詞ワ行五段	
かなた	｜彼方《かなた》	名詞	
かば	｜庇《かば》	動詞ワ行五段	
かぶ	｜被《かぶ》	動詞ラ行五段	
かぶ	｜被《かぶ》	動詞一段	
かぶ	｜齧《かぶ》	動詞ラ行五段	
かぶりつ	｜齧《かぶ》りつ	動詞カ行五段	
かまど	｜竈《かまど》	名詞	
かみて	｜上手《かみて》	名詞	
かめ	｜瓶《かめ》	名詞	
から	｜辛《から》	形容詞	
からか	｜誂《からか》	動詞ワ行五段	
かわ	｜躱《かわ》	動詞サ行五段	
かわい	｜可愛《かわい》	形容詞	
かわいそう	｜可哀相《かわいそう》	名詞形動	
かわます	｜川鱒《カワマス》	名詞	
かんぬき	｜閂《かんぬき》	名詞	
かんばつ	｜旱魃《かんばつ》	名詞	
かんみ	｜甘味《かんみ》	名詞	
がーでぃあん	｜守護者《ガーディアン》	名詞	
がーねっと	｜柘榴石《ガーネット》	名詞	
がい	｜甲斐《がい》	名詞	
がいく	｜骸躯《がいく》	名詞	
がぜん	｜俄然《がぜん》	名詞	
がちょう	｜鵞鳥《ガチョウ》	名詞	
き	｜訊《き》	動詞カ行五段	
きゃしゃ	｜華奢《きゃしゃ》	名詞形動	
きゅうきょ	｜急遽《きゅうきょ》	名詞	
きゅうしゃ	｜厩舎《きゅうしゃ》	名詞	
きゅうり	｜胡瓜《きゅうり》	名詞	
きょう	｜饗《きょう》	動詞サ行五段	
きょう	｜今日《きょう》	名詞	
きょうおう	｜饗応《きょうおう》	名詞サ変	
きょうがく	｜驚愕《きょうがく》	名詞サ変	
きょうざめ	｜興醒《きょうざ》め	名詞形動	
きょうじん	｜強靭《きょうじん》	名詞形動	
きょうせい	｜嬌声《きょうせい》	名詞	
きょく	｜巨?《きょく》	名詞	
きっぷ	｜気っ風《きっぷ》	名詞	
きこり	｜樵《きこり》	名詞	
きさき	｜妃《きさき》	名詞	
きざ	｜気障《きざ》	名詞形動	
きし	｜軋《きし》	動詞マ行五段	
きぜん	｜毅然《きぜん》	名詞形動	
きつりつ	｜屹立《きつりつ》	名詞サ変	
きのう	｜昨日《きのう》	名詞	
きびす	｜踵《きびす》	名詞	
きぶた	｜木蓋《きぶた》	名詞	
きらびやか	｜煌《きら》びやか	名詞形動	
きらめ	｜煌《きら》め	動詞カ行五段	
きれい	｜綺麗《きれい》	名詞形動	
ぎょうこう	｜行幸《ぎょうこう》	名詞	
ぎょしゃ	｜馭者《ぎょしゃ》	名詞	
く	｜汲《く》	動詞マ行五段	
く	｜刳《く》	動詞ラ行五段	
く	｜酌《く》	動詞マ行五段	
くく	｜括《くく》	動詞ラ行五段	
くぐ	｜潜《くぐ》	動詞ラ行五段	
くさ	｜臭《くさ》	形容詞	
くさりかたびら	｜鎖帷子《くさりかたびら》	名詞	
くしゃみ	｜嚔《くしゃみ》	名詞	
くずおれ	｜頽《くずお》れ	動詞一段	
くだん	｜件《くだん》	名詞	
くちのは	口の｜端《は》	名詞	
くちは	｜口端《くちは》	名詞	
くつろ	｜寛《くつろ》	動詞ガ行五段	
くびき	｜軛《くびき》	名詞	
くびれ	｜括《くび》れ	名詞形動	
くぼち	｜窪地《くぼち》	名詞	
くま	｜隈《くま》	名詞	
くも	｜曇《くも》	動詞ラ行五段	
くもん	｜苦悶《くもん》	名詞	
くら	｜眩《くら》	動詞マ行五段	
くるぶし	｜踝《くるぶし》	名詞	
くわ	｜鍬《くわ》	名詞	
くわえ	｜咥《くわ》え	動詞一段	
ぐらに	｜魔馬《グラニ》	名詞	
けあん	｜石塚《ケアン》	名詞	
けいつい	｜頚椎《けいつい》	名詞	
けいまい	｜兄妹《けいまい》	名詞	
けいれん	｜痙攣《けいれん》	名詞	
けそう	｜懸想《けそう》	名詞サ変	
けなげ	｜健気《けなげ》	名詞形動	
けんかっぱや	｜喧嘩《けんか》っ｜早《ぱや》	形容詞	
けんけんごうごう	｜喧々囂々《けんけんごうごう》	名詞形動	
けんげき	｜剣戟《けんげき》	名詞	
けんせい	｜牽制《けんせい》	名詞サ変	
けんぞく	｜眷属《けんぞく》	名詞	
けんのん	｜剣呑《けんのん》	名詞形動	
けんろう	｜堅牢《けんろう》	名詞形動	
げいか	｜猊下《げいか》	名詞	
こ	｜娘《こ》	名詞	
こ	｜籠《こ》	動詞マ行五段	
こっく	｜活栓《コック》	名詞	
こっぱみじん	｜木端微塵《こっぱみじん》	名詞	
こうきょ	｜溝渠《こうきょ》	名詞	
こうこう	｜浩々《こうこう》	副詞	
こうこう	｜煌々《こうこう》	副詞	
こうこつ	｜恍惚《こうこつ》	名詞形動	
こうし	｜嚆矢《こうし》	名詞	
こうしょう	｜口誦《こうしょう》	名詞サ変	
こうしょう	｜工廠《こうしょう》	名詞	
こうちゃく	｜膠着《こうちゃく》	名詞	
こうぶ	｜荒蕪《こうぶ》	名詞形動	
こうべ	｜頭《こうべ》	名詞	
こうもり	｜蝙蝠《コウモリ》	名詞	
こぎれい	｜小綺麗《こぎれい》	名詞形動	
こけん	｜沽券《こけん》	名詞	
こしゃく	｜小癪《こしゃく》	名詞	
こす	｜擦《こす》	動詞ラ行五段	
こそく	｜姑息《こそく》	名詞形動	
こたえ	｜堪《こた》え	動詞一段	
こだま	｜谺《こだま》	名詞サ変	
こだわ	｜拘《こだわ》	動詞ラ行五段	
こつ	｜骨《こつ》	名詞	
ことごとく	｜悉《ことごと》く	副詞	
ことほ	｜言祝《ことほ》	動詞ガ行五段	
こな	｜熟《こな》	動詞サ行五段	
こなた	｜此方《こなた》	名詞	
こにかるはっと	｜三角帽子《コニカルハット》	名詞	
こぶし	｜拳《こぶし》	名詞	
こぼ	｜零《こぼ》	動詞サ行五段	
こぼ	｜零《こぼ》	動詞ラ変	
こも	｜籠《こ》も	動詞ラ行五段	
こらえ	｜堪《こら》え	動詞一段	
こわく	｜蠱惑《こわく》	名詞形動	
こわば	｜強張《こわば》	動詞ラ行五段	
こんくりーと	｜混凝土《コンクリート》	名詞	
こんしん	｜渾身《こんしん》	名詞形動	
こんぜんいったい	｜渾然一体《こんぜんいったい》	名詞形動	
こんぼう	｜棍棒《こんぼう》	名詞	
ごうおん	｜轟音《ごうおん》	名詞	
ごうごう	｜轟々《ごうごう》	名詞形動	
ごうまん	｜傲慢《ごうまん》	名詞	
ごちそう	｜御馳走《ごちそう》	名詞	
ごと	｜如《ごと》	連体詞	
ごまか	｜誤魔化《ごまか》	動詞サ行五段	
さ	｜射《さ》	動詞サ行五段	
さっそう	｜颯爽《さっそう》	名詞	
さーどにっくす	｜紅縞瑪瑙《サードニックス》	名詞	
さいころ	｜骰子《さいころ》	名詞	
さえず	｜囀《さえず》	動詞ラ行五段	
さかのぼ	｜遡《さかのぼ》	動詞ラ行五段	
さきおととい	｜一昨々日《さきおととい》	名詞	
さけ	｜鮭《サケ》	名詞	
ささや	｜囁《ささや》	動詞カ行五段	
さじ	｜匙《さじ》	名詞	
さじかげん	｜匙加減《さじかげん》	名詞	
さす	｜擦《さす》	動詞ラ行五段	
さなか	｜最中《さなか》	名詞	
さながら	｜宛《さなが》ら	副詞	
さば	｜捌《さば》	動詞カ行五段	
さまよ	｜彷徨《さまよ》	動詞ワ行五段	
さら	｜攫《さら》	動詞ワ行五段	
さらまんだー	｜火の精霊《サラマンダー》	名詞	
さんご	｜珊瑚《さんご》	名詞	
さんごしょう	｜珊瑚礁《さんごしょう》	名詞	
さんさん	｜燦々《さんさん》	名詞	
さんし	｜参仕《さんし》	名詞	
さんだつ	｜簒奪《さんだつ》	名詞サ変	
ざんし	｜残滓《ざんし》	名詞	
しゃし	｜奢侈《しゃし》	名詞形動	
しゃれ	｜洒落《しゃれ》	名詞	
しゃれ	｜洒落《しゃれ》	動詞ラ行五段	
しゅ	｜主《しゅ》	名詞	
しゅうてき	｜讐敵《しゅうてき》	名詞	
しゅんじゅん	｜逡巡《しゅんじゅん》	名詞サ変	
しゅんどう	｜蠢動《しゅんどう》	名詞形動	
しゅんれつ	｜峻烈《しゅんれつ》	名詞形動	
しょうしゃ	｜廠舎《しょうしゃ》	名詞	
しょうしゃ	｜瀟洒《しょうしゃ》	名詞形動	
しょくだい	｜燭台《しょくだい》	名詞	
しょくにんかたぎ	｜職人気質《しょくにんかたぎ》	名詞	
しょくゆう	｜贖宥《しょくゆう》	名詞	
しっぽ	｜尻尾《しっぽ》	名詞	
しーん・すぎーる	｜妖精の物語《シーン・スギール》	名詞	
しあさって	｜明々後日《しあさって》	名詞	
しか	｜然《しか》	動詞ラ行五段	
しかばね	｜屍《しかばね》	名詞	
しかめ	｜顰《しか》め	動詞一段	
しかん	｜弛緩《しかん》	名詞サ変	
しぎゃく	｜嗜虐《しぎゃく》	名詞	
しぎゃくしん	｜嗜虐心《しぎゃくしん》	名詞	
しぎゃくてき	｜嗜虐的《しぎゃくてき》	名詞	
しげりば	｜茂葉《しげりば》	名詞	
しご	｜扱《しご》	動詞カ行五段	
しし	｜獅子《しし》	名詞	
しじょう	｜市場《しじょう》	名詞	
しじま	｜静寂《しじま》	名詞	
しずく	｜雫《しずく》	名詞	
したて	｜下手《したて》	名詞形動	
しちょうへい	｜輜重兵《しちょうへい》	名詞	
しつけ	｜躾《しつけ》	名詞	
しつらえ	｜設《しつら》え	動詞一段	
してい	｜姉弟《してい》	名詞	
しとね	｜褥《しとね》	名詞	
しとやか	｜淑《しと》やか	名詞形動	
しな	｜科《しな》	名詞	
しな	｜品《しな》	名詞	
しの	｜凌《しの》	動詞ガ行五段	
しばし	｜暫《しば》し	副詞	
しばらく	｜暫《しば》らく	副詞	
しばらく	暫《しばら》く	副詞	
しぶき	｜飛沫《しぶき》	名詞	
しもて	｜下手《しもて》	名詞	
しらかば	｜白樺《シラカバ》	名詞	
しらが	｜白髪《しらが》	名詞	
しりぞけ	｜斥《しりぞ》け	動詞一段	
しるふ	｜風の精霊《シルフ》	名詞	
しわくちゃ	｜皺苦茶《しわくちゃ》	名詞	
しんかん	｜震撼《しんかん》	名詞サ変	
しんがり	｜殿《しんがり》	名詞	
じゃこう	｜麝香《じゃこう》	名詞	
じゃれ	｜戯《じゃ》れ	動詞一段	
じゅそう	｜樹叢《じゅそう》	名詞	
じょうず	｜上手《じょうず》	名詞形動	
じょうぜつ	｜饒舌《じょうぜつ》	名詞形動	
じょしん	｜女神《じょしん》	名詞	
じょじょう	｜抒情《じょじょう》	名詞	
じょじょうし	｜抒情詩《じょじょうし》	名詞	
じい	｜爺《じい》	名詞	
じき	｜直《じき》	副詞	
じしゃ	｜侍者《じしゃ》	名詞	
じだ	｜耳朶《じだ》	名詞	
じれ	｜焦《じ》れ	動詞一段	
じろう	｜耳聾《じろう》	名詞	
じんかい	｜塵芥《じんかい》	名詞	
す	｜空《す》	動詞カ行五段	
す	｜磨《す》	動詞ラ行五段	
すっとんきょう	｜素っ頓狂《すっとんきょう》	名詞形動	
すいか	｜誰何《すいか》	名詞サ変	
すいたい	｜推戴《すいたい》	名詞サ変	
すうせい	｜趨勢《すうせい》	名詞	
すかさず	｜隙《す》かさず	名詞	
すが	｜縋《すが》	動詞ラ行五段	
すがすがし	｜清々《すがすが》し	形容詞	
すがめ	｜眇《すが》め	動詞一段	
すき	｜犁《すき》	名詞	
すきさき	｜犁先《すきさき》	名詞	
すく	｜竦《すく》	動詞マ行五段	
すく	｜掬《すく》	動詞ワ行五段	
すくりぶなー	｜書写者《スクリブナー》	名詞	
すぐ	｜直《す》ぐ	副詞	
すご	｜凄《すご》	形容詞	
すさまじ	｜凄《すさ》まじ	形容詞	
すす	｜啜《すす》	動詞ラ行五段	
すなわち	｜即《すなわ》ち	接続詞	
すね	｜脛《すね》	名詞	
すべ	｜術《すべ》	名詞	
すみか	｜棲《す》み｜処《か》	名詞	
ずいぶん	｜随分《ずいぶん》	名詞	
ずうずうし	｜図々《ずうずう》し	形容詞	
ずたぶくろ	｜頭陀袋《ずたぶくろ》	名詞	
せっぷん	｜接吻《せっぷん》	名詞サ変	
せいえん	｜聖焔《せいえん》	名詞	
せいかん	｜精悍《せいかん》	名詞形動	
せいさん	｜凄惨《せいさん》	名詞形動	
せいさん	｜正餐《せいさん》	名詞	
せいじゃく	｜静寂《せいじゃく》	名詞	
せいひつ	｜静謐《せいひつ》	名詞形動	
せかんど・さいと	｜透視力《セカンド・サイト》	名詞	
せきふ	｜石斧《せきふ》	名詞	
せきりょう	｜寂寥《せきりょう》	名詞形動	
せつな	｜刹那《せつな》	名詞	
せま	｜迫《せま》	動詞ラ行五段	
せらふぃん	｜御使い《セラフィン》	名詞	
せりふ	｜台詞《せりふ》	名詞	
せんえい	｜尖鋭《せんえい》	名詞形動	
せんてぃなりー	｜百年祭《センティナリー》	名詞	
せんとーる	｜半人半馬《セントール》	名詞	
ぜいたく	｜贅沢《ぜいたく》	名詞	
そ	｜削《そ》	動詞ガ行五段	
そっぽ	｜外方《そっぽう》	名詞	
そっぽう	｜外方《そっぽう》	名詞	
そうきゅう	｜双丘《そうきゅう》	名詞	
そうく	｜痩?《そうく》	名詞	
そうせい	｜叢生《そうせい》	名詞サ変	
そうのう	｜奏納《そうのう》	名詞サ変	
そうぼう	｜双眸《そうぼう》	名詞	
そうも	｜叢茂《そうも》	名詞サ変	
そこここ	｜其処此処《そこここ》	名詞	
そしゃく	｜咀嚼《そしゃく》	名詞サ変	
そそのか	｜唆《そそのか》	動詞サ行五段	
そぞろ	｜漫《そぞ》ろ	副詞	
そば	｜側《そば》	名詞	
そば	｜傍《そば》	名詞	
そびえ	｜聳《そび》え	動詞一段	
そよかぜ	｜微風《そよかぜ》	名詞	
そら	｜逸《そ》ら	動詞サ行五段	
それ	｜逸《そ》れ	動詞一段	
それがし	｜某《それがし》	名詞	
そろ	｜揃《そろ》	動詞ワ行五段	
た	｜焚《た》	動詞カ行五段	
たっけい	｜磔刑《たっけい》	名詞	
たいく	｜体?《たいく》	名詞	
たいせい	｜大勢《たいせい》	名詞	
たえ	｜堪《た》え	動詞一段	
たえ	｜妙《たえ》	名詞形動	
たおやか	｜嫋《たお》やか	名詞形動	
たぎ	｜滾《たぎ》	動詞ラ行五段	
たくさん	｜沢山《たくさん》	副詞	
たくまし	｜逞《たくま》し	形容詞	
たけ	｜長《た》け	動詞一段	
たたえ	｜讃《たた》え	動詞一段	
たたえ	｜湛《たた》え	動詞一段	
たたず	｜佇《たたず》	動詞マ行五段	
ただなか	｜只中《ただなか》	名詞	
たど	｜辿《たど》	動詞ラ行五段	
たどりつ	｜辿《たど》り着	動詞カ行五段	
たにあい	｜谷間《たにあい》	名詞	
たにま	｜谷間《たにま》	名詞	
たま	｜堪《たま》	動詞ラ行五段	
たま	｜溜《た》ま	動詞ラ行五段	
たまにきず	玉に｜瑕《きず》	名詞	
たむろ	｜屯《たむろ》	名詞サ変	
ため	｜溜《た》め	動詞一段	
ためつすがめつ	｜矯《た》めつ｜眇《すが》めつ	連体詞	
ためら	｜躊躇《ためら》	動詞ワ行五段	
たやす	｜容易《たやす》	形容詞	
たらい	｜盥《たらい》	名詞	
たる	｜樽《たる》	名詞	
たわむれ	｜戯《たわむ》れ	動詞一段	
たんく	｜短?《たんく》	名詞	
だっと	｜脱兎《だっと》	名詞	
だいごみ	｜醍醐味《だいごみ》	名詞	
だいじ	｜大事《だいじ》	名詞	
だいだいいろ	｜橙色《だいだいいろ》	名詞	
だちょう	｜駝鳥《ダチョウ》	名詞	
だつりゃく	｜奪掠《だつりゃく》	名詞サ変	
だま	｜騙《だま》	動詞サ行五段	
ちぇんじりんぐ	｜取り替え子《チェンジリング》	名詞	
ちゅうちょ	｜躊躇《ちゅうちょ》	名詞サ変	
ちょう	｜長《ちょう》	名詞	
ちょうく	｜長?《ちょうく》	名詞	
ちょうちゃく	｜打擲《ちょうちゃく》	名詞サ変	
ちょうちょうはっし	｜丁々発止《ちょうちょうはっし》	副詞	
ちょうつがい	｜蝶番《ちょうつがい》	名詞	
ちょうらく	｜凋落《ちょうらく》	名詞サ変	
ちょうろう	｜嘲弄《ちょうろう》	名詞サ変	
ちょこざい	｜猪口才《ちょこざい》	副詞	
ちかし	｜親《ちか》し	形容詞	
ちからずく	｜力尽《ちからず》く	名詞	
ちき	｜知己《ちき》	名詞	
ちぎ	｜契《ちぎ》	動詞ラ行五段	
ちげき	｜地隙《ちげき》	名詞	
ちなみ	｜因《ちな》み	副詞	
つ	｜衝《つ》	動詞カ行五段	
つ	｜点《つ》	動詞カ行五段	
つ	｜吐《つ》	動詞カ行五段	
つ	｜憑《つ》	動詞カ行五段	
つ	｜吊《つ》	動詞ラ行五段	
つっかえ	｜支《つっか》え	動詞一段	
ついで	｜序《つい》で	名詞	
ついに	｜遂《つい》に	副詞	
ついば	｜啄《ついば》	動詞マ行五段	
つうよう	｜痛痒《つうよう》	名詞	
つか	｜掴《つか》	動詞マ行五段	
つか	｜柄《つか》	名詞	
つかえ	｜支《つか》え	動詞一段	
つかさど	｜司《つかさど》	動詞ラ行五段	
つかじり	｜柄尻《つかじり》	名詞	
つかのま	｜束《つか》の間	名詞	
つきやま	｜築山《つきやま》	名詞	
つた	｜蔦《つた》	名詞	
つたな	｜拙《つたな》	形容詞	
つちぼこり	｜土埃《つちぼこり》	名詞	
つて	｜伝《つて》	名詞	
つな	｜繋《つな》	動詞ガ行五段	
つなが	｜繋《つな》が	動詞ラ行五段	
つなげ	｜繋《つな》げ	動詞ラ行五段	
つの	｜角《つの》	名詞	
つぶや	｜呟《つぶや》	動詞カ行五段	
つぼみ	｜蕾《つぼみ》	名詞	
つま	｜摘《つま》	動詞マ行五段	
つまず	｜躓《つまず》	動詞カ行五段	
つむ	｜瞑《つむ》	動詞ラ行五段	
つや	｜艶《つや》	名詞	
つら	｜辛《つら》	形容詞	
つる	｜蔓《つる》	名詞	
つわもの	｜兵《つわもの》	名詞	
つんざ	｜劈《つんざ》	動詞カ行五段	
づか	｜掴《づか》	動詞マ行五段	
てぃーんど	｜十分の一税《ティーンド》	名詞	
てぃる・てるんぎり	｜波の下の国《ティル・テルンギリ》	名詞	
てぃる・な・のぐ	｜常若の国《ティル・ナ・ノグ》	名詞	
てっつい	｜鉄鎚《てっつい》	名詞	
てーぶるず	｜双六《テーブルズ》	名詞	
てい	｜体《てい》	名詞	
てい	｜挺《てい》	動詞サ行五段	
ていぞく	｜蹄族《ていぞく》	名詞	
てきめん	｜覿面《てきめん》	名詞形動	
てはず	｜手筈《てはず》	名詞	
と	｜留《と》	動詞マ行五段	
と	｜止《と》	動詞マ行五段	
とぅあは	｜種族《トゥアハ》	名詞	
とぅむらす	｜埋葬丘《トゥムラス》	名詞	
とっさ	｜咄嗟《とっさ》	名詞	
とって	｜把手《とって》	名詞	
とうとう	｜滔々《とうとう》	名詞	
とうひ	｜唐檜《トウヒ》	名詞	
とうりゅう	｜逗留《とうりゅう》	名詞サ変	
とかげ	｜蜥蜴《トカゲ》	名詞	
とが	｜尖《とが》	動詞ラ行五段	
とが	｜咎《とが》	動詞マ行五段	
とき	｜時《とき》	助数詞	
とき	｜鬨《とき》	名詞	
とくしゅ	｜特種《とくしゅ》	名詞	
とくだね	｜特種《とくだね》	名詞	
とくとう	｜禿頭《とくとう》	名詞	
としがい	｜年甲斐《としがい》	名詞	
としま	｜年増《としま》	名詞形動	
とどま	｜留《とど》ま	動詞ラ行五段	
とどめ	｜止《とど》め	名詞	
とどめ	｜留《とど》め	動詞一段	
とどろ	｜轟《とどろ》	動詞カ行五段	
とにかく	｜兎《と》に角	副詞	
とねりこ	｜秦皮《トネリコ》	名詞	
とびしさ	飛び｜退《しさ》	動詞ラ行五段	
とも	｜灯《とも》	動詞サ行五段	
とも	｜点《とも》	動詞サ行五段	
ともえ	｜巴《ともえ》	名詞	
ともえなげ	｜巴投《ともえな》げ	名詞	
とら	｜囚《とら》	動詞ワ行五段	
とらわ	｜囚《とら》わ	動詞一段	
とらわれ	｜囚《とら》われ	名詞	
とりあえず	取り｜敢《あ》えず	副詞	
とんきょう	｜頓狂《とんきょう》	名詞形動	
どぅるいど	｜樫の賢人《ドゥルイド》	名詞	
どうかつ	｜恫喝《どうかつ》	名詞サ変	
どうけつ	｜洞穴《どうけつ》	名詞	
どうてい	｜道程《どうてい》	名詞	
どうもく	｜瞠目《どうもく》	名詞サ変	
どくし	｜読師《どくし》	名詞	
な	｜為《な》	動詞サ行五段	
な	｜生《な》	動詞サ行五段	
な	｜薙《な》	動詞ガ行五段	
なお	｜尚《なお》	副詞	
ながえ	｜轅《ながえ》	名詞	
なごり	｜名残《なごり》	名詞	
なじ	｜馴染《なじ》	動詞マ行五段	
なす	｜茄子《なす》	名詞	
なすすべ	｜為《な》す｜術《すべ》	名詞	
なぜ	｜何故《なぜ》	副詞	
なた	｜鉈《なた》	名詞	
なだ	｜傾《なだ》	動詞ラ行五段	
なだめ	｜宥《なだ》め	動詞一段	
なだめ	｜傾《なだ》め	動詞一段	
なで	｜撫《な》で	動詞一段	
なび	｜靡《なび》	動詞カ行五段	
なま	｜訛《なま》	動詞ラ行五段	
なまくら	｜鈍《なまく》ら	名詞形動	
なまめかし	｜艶《なま》めかし	形容詞	
なりわい	｜生業《なりわい》	名詞	
なんにん	｜何人《なんにん》	名詞	
なんぱ	｜軟派《なんぱ》	名詞サ変	
なんびと	｜何人《なんびと》	名詞	
にい	｜兄《にい》	名詞	
にいさん	｜兄《にい》さん	名詞	
にいちゃん	｜兄《にい》ちゃん	名詞	
におい	｜臭《にお》い	名詞	
にぎ	｜賑《にぎ》	動詞ワ行五段	
にぎやか	｜賑《にぎ》やか	名詞形動	
にく	｜難《にく》	形容詞	
にじ	｜滲《にじ》	動詞マ行五段	
にもかかわ	にも｜拘《かかわ》	動詞ラ行五段	
にら	｜睨《にら》	動詞マ行五段	
にれ	｜楡《ニレ》	名詞	
ぬ	｜濡《ぬ》	動詞ラ行五段	
ぬかる	｜泥濘《ぬかる》	動詞マ行五段	
ぬし	｜主《ぬし》	名詞	
ぬる	｜温《ぬる》	動詞マ行五段	
ぬる	｜温《ぬる》	形容詞	
ね	｜音《ね》	名詞	
ねえ	｜姉《ねえ》	名詞	
ねえさん	｜姉《ねえ》さん	名詞	
ねえちゃん	｜姉《ねえ》ちゃん	名詞	
ねぎら	｜労《ねぎら》	動詞ワ行五段	
ねじ	｜捩《ねじ》	動詞ラ行五段	
ねじき	｜捩《ね》じ切	動詞ラ行五段	
の	｜呑《の》	動詞マ行五段	
の	｜伸《の》	動詞サ行五段	
のっと	｜則《のっと》	動詞ラ行五段	
のーむ	｜土の精霊《ノーム》	名詞	
のうしょう	｜脳漿《のうしょう》	名詞	
のぞ	｜覗《のぞ》	動詞カ行五段	
のんき	｜暢気《のんき》	名詞形動	
は	｜刃《は》	名詞	
は	｜穿《は》	動詞カ行五段	
は	｜吐《は》	動詞カ行五段	
は	｜這《は》	動詞ワ行五段	
は	｜佩《は》	動詞カ行五段	
はいき	｜拝跪《はいき》	名詞サ変	
はいけん	｜佩剣《はいけん》	名詞サ変	
はいらんど	｜高地地方《ハイランド》	名詞	
はかな	｜儚《はかな》	形容詞	
はかなげ	｜儚《はかな》げ	副詞	
はくさ	｜白砂《はくさ》	名詞	
はくしきこうぶん	｜博識洽聞《はくしきこうぶん》	名詞	
はくはつ	｜白髪《はくはつ》	名詞	
はぐ	｜妖老《ハグ》	名詞	
はこぼれ	｜刃毀《はこぼ》れ	名詞サ変	
はしゅ	｜播種《はしゅ》	名詞サ変	
はしばみ	｜榛《はしばみ》	名詞	
はしら	｜柱《はしら》	助数詞	
はす	｜斜《はす》	名詞	
はすむかい	｜斜向《はすむ》かい	名詞	
はず	｜筈《はず》	名詞	
はせ	｜馳《は》せ	動詞一段	
はた	｜叩《はた》	動詞カ行五段	
はつらつ	｜溌剌《はつらつ》	名詞形動	
はなはだ	｜甚《はなは》だ	副詞	
はね	｜刎《は》ね	動詞一段	
はばか	｜憚《はばか》	動詞ラ行五段	
はびこ	｜蔓延《はびこ》	動詞ラ行五段	
はま	｜嵌《は》ま	動詞ラ行五段	
はみ	｜銜《はみ》	名詞	
はめ	｜嵌《は》め	動詞ラ行五段	
はや	｜流行《はや》	動詞ラ行五段	
はや	｜囃《はや》	動詞サ行五段	
はらから	｜同胞《はらから》	名詞	
はりつけ	｜磔《はりつけ》	名詞	
はるか	｜遥《はる》か	名詞形動	
はるかかなた	｜遥《はる》か｜彼方《かなた》	名詞	
はるばーど	｜斧槍《ハルバード》	名詞	
はるばる	｜遥々《はるばる》	副詞	
はんえん	｜繁衍《はんえん》	名詞サ変	
はんばく	｜反駁《はんばく》	名詞サ変	
ばっこ	｜跋扈《ばっこ》	名詞サ変	
ばあ	｜婆《ばあ》	名詞	
ばか	｜馬鹿《ばか》	名詞	
ばら	｜薔薇《バラ》	名詞	
ばるこにー	｜露台《バルコニー》	名詞	
ばんさん	｜晩餐《ばんさん》	名詞	
ばんじゅう	｜輓獣《ばんじゅう》	名詞	
ひ	｜惹《ひ》	動詞カ行五段	
ひょうびょう	｜縹渺《ひょうびょう》	名詞形動	
ひきず	引き｜摺《ず》	動詞ラ行五段	
ひきにく	｜挽肉《ひきにく》	名詞	
ひごと	｜日毎《ひごと》	名詞	
ひざまず	｜跪《ひざまず》	動詞カ行五段	
ひだ	｜襞《ひだ》	名詞	
ひだかざり	｜襞飾《ひだかざ》り	名詞	
ひつ	｜櫃《ひつ》	名詞	
ひづめ	｜蹄《ひづめ》	名詞	
ひときわ	｜一際《ひときわ》	副詞	
ひとくくり	｜一括《ひとくく》り	名詞	
ひとけ	｜人気《ひとけ》	名詞	
ひとしきり	｜一頻《ひとしき》り	名詞	
ひととき	｜一時《ひととき》	名詞	
ひととなり	｜為人《ひととなり》	名詞	
ひとまず	｜一先《ひとま》ず	副詞	
ひとりごち	｜独《ひと》り｜言《ご》ち	動詞一段	
ひど	｜酷《ひど》	形容詞	
ひなだん	｜雛壇《ひなだん》	名詞	
ひなだんせき	｜雛壇席《ひなだんせき》	名詞	
ひね	｜捻《ひね》	動詞ラ行五段	
ひら	｜平《ひら》	名詞形動	
ひらけ	｜開《ひら》け	動詞一段	
ひらめ	｜閃《ひらめ》	動詞カ行五段	
ひらめき	｜閃《ひらめ》き	名詞	
ひる	｜怯《ひる》	動詞マ行五段	
ひるがえ	｜翻《ひるがえ》	動詞ラ行五段	
ひると	｜柄《ヒルト》	名詞	
ひれふ	｜平伏《ひれふ》	動詞サ行五段	
ひん	｜品《ひん》	名詞	
ひん	｜瀕《ひん》	動詞サ行五段	
ひんし	｜瀕死《ひんし》	名詞形動	
びっくり	｜吃驚《びっくり》	副詞	
びん	｜瓶《びん》	名詞	
びんしょう	｜敏捷《びんしょう》	名詞形動	
ぴーと	｜泥炭《ピート》	名詞	
ふ	｜葺《ふ》	動詞カ行五段	
ふぁりー・うぇる	｜妖精の泉《フェアリー・ウェル》	名詞	
ふぇありー・そーん	｜妖精の茨《フェアリー・ソーン》	名詞	
ふぇありー・ひる	｜妖精の丘《フェアリー・ヒル》	名詞	
ふぇありー・ふぉんと	｜妖精の棲み処《フェアリー・フォント》	名詞	
ふぇありー・まーけっと	｜妖精市場《フェアリー・マーケット》	名詞	
ふぇありー・みっどわいふ	｜妖精の産婆《フェアリー・ミッドワイフ》	名詞	
ふぇありー・らいど	｜妖精騎馬行《フェアリー・ライド》	名詞	
ふぇありー・りんぐ	｜妖精の輪《フェアリー・リング》	名詞	
ふぉーん	｜半人半山羊《フォーン》	名詞	
ふぉいぞん	｜成分の本質《フォイゾン》	名詞	
ふくらはぎ	｜脹脛《ふくらはぎ》	名詞	
ふけ	｜耽《ふけ》	動詞ラ行五段	
ふさ	｜塞《ふさ》	動詞ガ行五段	
ふさわし	｜相応《ふさわ》し	形容詞	
ふた	｜蓋《ふた》	名詞	
ふち	｜縁《ふち》	名詞	
ふつまし	｜祓魔師《ふつまし》	名詞	
ふてくさ	｜不貞腐《ふてくさ》	動詞ラ行五段	
ふらち	｜不埒《ふらち》	名詞	
ふんす	｜扮《ふん》す	動詞一段	
ふんそう	｜扮装《ふんそう》	名詞サ変	
ふんまん	｜憤懣《ふんまん》	名詞	
ぶ	｜葺《ぶ》	動詞カ行五段	
ぶ	｜分《ぶ》	助数詞	
ぶ	｜打《ぶ》	動詞タ行五段	
ぶっつけ	｜打《ぶ》っつけ	動詞一段	
ぶぎ	｜舞妓《ぶぎ》	名詞	
ぶちこ	｜打《ぶ》ち込	動詞マ行五段	
ぶつか	｜打《ぶ》つか	動詞一段	
ぶつか	｜打《ぶ》つか	動詞ラ行五段	
ぶつけ	｜打《ぶ》つけ	動詞一段	
ぶてない	｜打《ぶ》てない	名詞形動	
ぶどう	｜葡萄《ぶどう》	名詞	
ぶんど	｜分捕《ぶんど》	動詞ラ行五段	
へ	｜圧《へ》	動詞サ行五段	
へい	｜炳《へい》	名詞形動	
へいげい	｜睥睨《へいげい》	名詞形動	
へいたん	｜兵站《へいたん》	名詞	
へう゛ぃ・あーまー	｜重甲冑《ヘヴィ・アーマー》	名詞	
へきがん	｜碧眼《へきがん》	名詞	
へきち	｜僻地《へきち》	名詞	
へこ	｜凹《へこ》	動詞マ行五段	
へた	｜下手《へた》	名詞形動	
へるでんぶっふ	｜英雄物語《ヘルデンブッフ》	名詞	
へるむ	｜兜《ヘルム》	名詞	
へんりん	｜片鱗《へんりん》	名詞	
べっぴん	｜別嬪《べっぴん》	名詞形動	
ぺいがん	｜異教徒《ペイガン》	名詞	
ぺいそす	｜哀感《ペイソス》	名詞	
ぺとろぐりふ	｜線刻文字《ペトログリフ》	名詞	
ほーる	｜広間《ホール》	名詞	
ほうふつ	｜彷彿《ほうふつ》	名詞	
ほえ	｜吠《ほ》え	動詞一段	
ほこり	｜埃《ほこり》	名詞	
ほころ	｜綻《ほころ》	動詞バ行五段	
ほとばし	｜迸《ほとばし》	動詞ラ行五段	
ほとり	｜畔《ほとり》	名詞	
ほの	｜仄《ほの》	接頭語	
ほのか	｜仄《ほの》か	名詞形動	
ほふ	｜屠《ほふ》	動詞ラ行五段	
ほほえ	｜微笑《ほほえ》	動詞マ行五段	
ほほえ	｜微笑《ほほえ》	動詞一段	
ほらあな	｜洞穴《ほらあな》	名詞	
ほれ	｜惚《ほ》れ	動詞一段	
ほんろう	｜翻弄《ほんろう》	名詞サ変	
ぼうぜん	｜呆然《ぼうぜん》	名詞形動	
ぼろ	｜襤褸《ぼろ》	名詞	
ま	｜撒《ま》	動詞カ行五段	
ま	｜蒔《ま》	動詞カ行五段	
まっしぐら	｜驀地《まっしぐら》	名詞形動	
まうんど	｜土塚《マウンド》	名詞	
まく	｜捲《まく》	動詞ラ行五段	
まくしたて	｜捲《まく》し立て	動詞一段	
まぐ・める	｜喜びが原《マグ・メル》	名詞	
まことしやか	｜実《まこと》しやか	名詞	
まじな	｜呪《まじな》	動詞ワ行五段	
まず	｜拙《まず》	形容詞	
まず	｜不味《まず》	形容詞	
また	｜跨《また》	動詞ガ行五段	
またが	｜跨《また》が	動詞ラ行五段	
まと	｜纏《まと》	動詞ワ行五段	
まとも	｜真面《まとも》	名詞形動	
まなじり	｜眦《まなじり》	名詞	
まね	｜真似《まね》	名詞サ変	
まね	｜真似《まね》	動詞一段	
まねごと	｜真似事《まねごと》	名詞	
まばた	｜瞬《まばた》	動詞カ行五段	
まばゆ	｜眩《まばゆ》	形容詞	
まぶし	｜眩《まぶ》し	形容詞	
まほうど	｜魔法弩《まほうど》	名詞	
まま	｜間々《まま》	名詞	
まま	｜儘《まま》	名詞	
まみ	｜塗《まみ》	動詞ラ行五段	
まれ	｜稀《まれ》	名詞形動	
まれふぃきうむ	｜有害な魔法《マレフィキウム》	名詞	
まわり	｜回《まわ》り	助数詞	
まんざら	｜満更《まんざら》	副詞	
みっどさまーでい	｜夏至の日《ミッドサマーデイ》	名詞	
みっどさまーでい・いぶ	｜夏至前夜《ミッドサマーデイ・イブ》	名詞	
みいだ	｜見出《みい》だ	動詞サ行五段	
みくに	｜御国《みくに》	名詞	
みこ	｜巫女《みこ》	名詞	
みこころ	｜御心《みこころ》	名詞	
みじん	｜微塵《みじん》	副詞	
みじん	｜微塵《みじん》	名詞	
みすとれす	｜女主人《ミストレス》	名詞	
みずおけ	｜水桶《みずおけ》	名詞	
みずしぶき	｜水飛沫《みずしぶき》	名詞	
みずみずし	｜瑞々《みずみず》し	形容詞	
みぞおち	｜鳩尾《みぞおち》	名詞	
みだしなみ	｜身嗜《みだしな》み	名詞	
みだら	｜淫《みだ》ら	名詞形動	
みちのり	｜道程《みちのり》	名詞	
みつどもえ	｜三つ巴《みつどもえ》	名詞	
みつろう	｜蜜蝋《みつろう》	名詞	
みとれ	｜見惚《みと》れ	動詞一段	
みな	｜御名《みな》	名詞	
みなぎ	｜漲《みなぎ》	動詞ラ行五段	
みなも	｜水面《みなも》	名詞	
みはるか	｜見遥《みはる》か	動詞サ行五段	
む	｜剥《む》	動詞カ行五段	
むくろ	｜骸《むくろ》	名詞	
むくろ	｜躯《むくろ》	名詞	
むげ	｜無下《むげ》	副詞	
むご	｜酷《むご》	形容詞	
むしろ	｜筵《むしろ》	名詞	
むせ	｜咽《むせ》	動詞一段	
むつ	｜睦《むつ》	動詞マ行五段	
めった	｜滅多《めった》	副詞	
めいす	｜職杖《メイス》	名詞	
めいす	｜鎚矛《メイス》	名詞	
めいど	｜女中《メイド》	名詞	
めがみ	｜女神《めがみ》	名詞	
めく	｜捲《めく》	動詞ラ行五段	
めす	｜雌《めす》	名詞	
めちゃ	｜滅茶《めちゃ》	名詞形動	
めちゃくちゃ	｜滅茶苦茶《めちゃくちゃ》	名詞形動	
めちゃめちゃ	｜滅茶滅茶《めちゃめちゃ》	名詞形動	
めまい	｜目眩《めまい》	名詞	
めんつ	｜面子《めんつ》	名詞	
もったい	｜勿体《もったい》	名詞形動	
もったいな	｜勿体無《もったいな》	形容詞	
もうろう	｜朦朧《もうろう》	名詞形動	
もが	｜藻掻《もが》	動詞カ行五段	
もぐ	｜潜《もぐ》	動詞ラ行五段	
もじ	｜捩《もじ》	動詞ラ行五段	
もたら	｜齎《もたら》	動詞サ行五段	
もちろん	｜勿論《もちろん》	名詞	
もてあそ	｜弄《もてあそ》	動詞バ行五段	
もてな	｜持《も》て｜成《な》	動詞サ行五段	
もと	｜下《もと》	名詞	
もはや	｜最早《もはや》	副詞	
もや	｜靄《もや》	名詞	
もら	｜貰《もら》	動詞ワ行五段	
や	｜遣《や》	動詞ラ行五段	
や	｜止《や》	動詞マ行五段	
や	｜輻《や》	名詞	
やいば	｜刃《やいば》	名詞	
やから	｜輩《やから》	名詞	
やけ	｜自棄《やけ》	名詞	
やす	｜易《やす》	形容詞	
やすやす	｜易々《やすやす》	副詞	
やつ	｜奴《やつ》	名詞	
やぶ	｜藪《やぶ》	名詞	
やぶさか	｜吝《やぶさ》か	名詞	
やぼ	｜野暮《やぼ》	名詞形動	
やりとり	｜遣《や》り取り	名詞サ変	
やるせな	｜遣《や》る｜瀬無《せな》	形容詞	
ゆううつ	｜憂鬱《ゆううつ》	名詞	
ゆうべ	｜昨夜《ゆうべ》	名詞	
ゆえん	｜所以《ゆえん》	名詞	
ゆかり	｜縁《ゆかり》	名詞	
ゆが	｜歪《ゆが》	動詞マ行五段	
ゆんづる	｜弓弦《ゆんづる》	名詞	
よ	｜依《よ》	動詞ラ行五段	
よ	｜選《よ》	動詞ラ行五段	
ようはい	｜腰背《ようはい》	名詞	
ようはい	｜遥拝《ようはい》	名詞	
ようやく	｜漸《ようや》く	副詞	
よぎ	｜過《よぎ》	動詞ラ行五段	
よこな	｜横薙《よこな》	動詞ガ行五段	
よし	｜葦《よし》	名詞	
よし	｜由《よし》	名詞	
よじ	｜捩《よじ》	動詞ラ行五段	
よそ	｜余所《よそ》	名詞	
よだれ	｜涎《よだれ》	名詞	
よろけ	｜蹌踉《よろ》け	動詞一段	
らーす	｜土砦《ラース》	名詞	
らいと・あーまー	｜軽甲冑《ライト・アーマー》	名詞	
らち	｜埒《らち》	名詞	
らちがい	｜埒外《らちがい》	名詞	
らんぐいば	｜乱杭歯《らんぐいば》	名詞	
りょうが	｜凌駕《りょうが》	名詞サ変	
りこう	｜犁耕《りこう》	名詞サ変	
りりし	｜凛々《りり》し	形容詞	
りん	｜厘《りん》	助数詞	
りん	｜凛《りん》	名詞	
りんこう	｜燐光《りんこう》	名詞	
りんご	｜林檎《リンゴ》	名詞	
りんぴ	｜鱗皮《りんぴ》	名詞	
るつぼ	｜坩堝《るつぼ》	名詞	
るびー	｜紅玉《ルビー》	名詞	
れっぱく	｜裂帛《れっぱく》	名詞	
れい	｜物語《レイ》	名詞	
れいて	｜忘却《レイテ》	名詞	
れがりあ	｜国王特権《レガリア》	名詞	
れば・がう゛ぁーら	｜侵略の書《レバ・ガヴァーラ》	名詞	
れぷらほーん	｜片足靴屋《レプラホーン》	名詞	
ろーらんど	｜低地地方《ローランド》	名詞	
ろう	｜蝋《ろう》	名詞	
ろうそく	｜蝋燭《ろうそく》	名詞	
ろく	｜陸《ろく》	名詞形動	
わ	｜詫《わ》	動詞バ行五段	
わいく	｜矮躯《わいく》	名詞	
わいしょう	｜矮小《わいしょう》	名詞	
わがまま	｜我儘《わがまま》	名詞形動	
わきあいあい	｜和気藹々《わきあいあい》	名詞形動	
わきまえ	｜弁《わきま》え	動詞一段	
わざ	｜業《わざ》	名詞	
わし	｜鷲《ワシ》	名詞	
わし	｜儂《わし》	名詞	
わしづか	｜鷲掴《わしづか》	動詞マ行五段	
わずか	｜僅《わず》か	名詞形動	
わだち	｜轍《わだち》	名詞	
わに	｜鰐《ワニ》	名詞	
わめ	｜喚《わめ》	動詞カ行五段	
わら	｜藁《わら》	名詞	
わらたば	｜藁束《わらたば》	名詞	
